00000111
11111101
10010111
11110100
01011111
11110010
10011110
11110011