0000000000#-#-#
0000000000|000|
#-#-#-@-#-#000#
|00000|000|000|
#00000#000@-#-#
|00000|000|0000
@-#-#-#000#0000
00|000|000|0000
00#000#-#-#-#-@
00|000|00000|00
#-@-#-@00000#00
|00000|00000|00
#00000#-#-#-#00
|00000|00000|00
#-#-@-#00000@-#