00000000001-1-10
1-1-1-1-1-100010
10000010001-1-10
1-1-1-1000100000
0010001-1-1-1-10
1-1-1-1000001000
1000001-1-1-1000
1-1-1-1000001-10